NO ./src/textures/madera1.png
SO ./src/textures/madera2.png
WE ./src/textures/madera3.png
EA ./src/textures/madera4.png

F 51,32,9
C 27,14,88

        1111111111111111111111111
        1000000000110000000000001
        101100000111000000N000001
        1001000000000000000000001
111111111011000001110000000000001
10000000001100001110111111111111
11110111111111011100000010001
11110111111110011101010010001
11000000110101011100000010001
10000000000000001100000010001
10000000000000001101010010001     
11000001110101011111011110011
11110111 1110101 101111010001
11111111 1111111 111111111111