NO ./path_to_the_north_texture
SO ./path_to_the_south_texture
             WE ./path_to_the_west_texture    




                  F 20,100,0         
C         225   ,    30,     50

EA ./path_to_the_east_texture

11111111111111