NO      ./src/textures/texture.xpm
SO ./src/textures/texture.xpm
WE ./src/textures/texture.xpm


F    222,    230  ,   100     
C    222,    3  ,  100			      
EA            ./src/textures/texture.xpm

                     11111111111
                     10000000001
                     10000000001
         1111111111  10000000001
         1000000001  10000000001