NO ./src/textures/madera1.png
SO ./src/textures/madera2.png
WE ./src/textures/madera3.png
EA ./src/textures/madera4.png

            11111111111
            10000000001
            10000000001
1111111111  10000000001
1000000001  1000000N001
1111111111  11111111111

F 220,100,0
C 225,30,255

